- 4 - - b - - P
- - - B - - - -
- - - - - - - -
- - c - - - - 2
- - - - - c - -
2 - - P - C - -
- - - C - - - -
- - c - - - c -
- - - - - - - -
b C - - B - c -
c c - - - c - -
C - - - - - 3 -
- - - - - - - -
- B - 1 - - b -
- - C c - C - -