- - - - b - - -
- - - B - - - -
- - c - - - - -
- - - - - C - -
- - b - - - - -
- - - - B - - -
C - - - - - - -
- - - - - - - -
- B - - - - b -
- - - - - - - -