- - C C - - P C
- c - - c - - C
C - - - c C - P
c - C - - - c -
c - c - c - C -
P - c - P - c -
- C P - - C - P
- c C - - - - c
- B b c C - P -
c c C - P C c -
P - - - - - - P
- c c C c c C c
- P - - - P - P
- - c C c - P -
- - C P - - - c
- - c - - P C -
- C - - - c - -
c - - - C - - -
C P P P P P P c
b - - - - - B -
- - P - - C - -
- - - - P - - P
c - C - - c - -
C - - P P - - -
- - P - - P P -
- P P - - - - -
P C - c - - - -
- c - - - - P -
- - C - - - - P
- - - - P C c B
c P P P c b P c
c P c - c - c -
c - P - C - c -
C - - - C - c -
- - - - - - c -
- P - - - - - -
- P P C P C - P
- C c P c P - C
c - - - c - C -
- - - c C - c -
- - - - c - C -
- - C - - - - -
- - - - c - - -
- - - c C c C c
P P P - - P P P
c C c P - P P P
- b - - - - P -
C - - - - - - -
- - - - - - - -