C 1 2 1 C 1 3 2
C 1 2 P 4 4 3 2
3 1 c C 4 1 3 c
C 1 2 1 C 2 3 2
3 1 c 1 4 1 3 c
C 1 2 1 4 1 3 2
C P - c P c - P
3 1 2 C 4 1 B 2
1 3 2 - 3 - - C
c 2 1 - 2 4 - -
- 1 - 4 - - 1 -
3 - C - P - - -
- 2 - 3 - - P 2
- 1 C 2 1 - 2 3
- P b B c 4 - c
c - P C 3 c - -
C 3 4 2 - - 1 -
4 2 1 - - 4 3 2
3 b 2 4 - 3 2 4
C 2 1 2 3 4 1 3
- C - C 1 - 4 -